TILEMAP
32 20							-- Size of tile map in tiles
16 16 							-- Tile size & block size
images/walls_green.png 	-- Tilesheet
10 10   
21 22 21 22 21 22 21 22 4 23 24 34 31 23 24 34 31 23 24 34 31 23 24 14 21 22 21 22 21 22 21 22 
22 21 22 21 22 21 22 21 1 0 0 0 0 0 0 0 0 0 0 0 0 0 0 11 22 21 22 21 22 21 22 21 
21 22 21 22 21 22 21 22 2 0 0 0 0 0 0 0 0 0 0 0 0 0 0 12 21 22 21 22 21 22 21 22 
22 21 22 21 22 21 22 21 3 0 0 0 0 0 0 0 0 0 0 0 0 0 0 13 22 21 22 21 22 21 22 21 
21 22 21 22 21 22 21 22 32 25 25 25 25 25 25 15 0 0 0 0 0 0 0 11 21 22 21 22 21 22 21 22 
4 23 24 34 31 23 24 34 31 23 24 34 31 41 24 34 0 0 0 0 0 0 0 12 22 21 22 21 22 21 22 21 
1 0 0 0 0 0 0 0 0 0 0 0 0 42 0 0 0 0 0 0 0 0 0 13 21 22 21 22 21 22 21 22 
2 0 0 0 0 0 0 0 0 0 0 0 0 42 0 0 0 0 0 0 0 0 0 11 22 21 22 21 22 21 22 21 
32 25 25 25 25 25 25 25 25 25 25 25 25 35 25 25 25 25 25 25 25 25 25 33 21 22 21 22 21 22 21 22 
21 22 21 22 21 22 21 22 4 23 41 34 31 23 24 34 31 23 24 34 31 23 24 34 31 23 24 34 31 23 24 34 
22 21 22 21 22 21 22 21 1 0 42 0 0 0 0 0 0 0 0 0 0 0 0 0 0 0 0 0 0 0 0 20 
21 22 21 22 21 22 21 22 2 0 42 0 0 0 0 0 0 0 0 0 0 0 0 0 0 0 0 0 0 0 0 20 
4 23 24 34 31 23 24 34 0 0 42 0 0 64 65 66 0 0 0 0 0 0 0 0 0 0 0 0 0 0 0 20 
2 0 0 0 0 0 0 0 0 0 42 0 0 74 75 76 0 0 0 0 0 5 25 25 25 25 25 25 25 25 25 25 
1 0 0 0 0 0 0 0 0 0 42 0 0 84 85 86 0 0 0 0 0 31 23 24 34 31 14 21 22 21 22 21 
32 25 25 25 25 25 25 25 25 25 35 25 25 94 95 96 15 0 0 0 0 0 0 0 0 0 0 23 24 34 31 23 
4 23 24 34 31 41 24 34 31 23 24 34 31 23 41 34 31 0 0 0 0 0 0 0 0 0 0 0 0 0 0 20 
3 0 0 0 0 42 0 0 0 0 0 0 0 0 42 0 0 0 0 0 0 54 55 53 0 0 0 0 0 0 0 20 
1 0 0 0 0 42 0 0 0 0 0 0 0 0 42 0 0 0 0 0 0 52 0 51 0 0 0 0 0 0 0 20 
32 25 25 25 25 35 25 25 25 25 25 25 25 25 35 25 25 25 25 25 25 43 25 44 25 25 25 25 25 25 25 25 