TILEMAP
32 20							-- Size of tile map in tiles
16 16 							-- Tile size & block size
images/walls_blue.png 	-- Tilesheet
10 10   
19 19 19 19 19 19 19 19 19 19 19 19 19 19 19 19 19 19 19 19 19 19 19 19 19 19 19 19 19 19 19 19 
2 0 0 0 0 42 0 0 0 0 0 0 0 0 0 0 0 0 0 0 0 0 42 0 0 0 0 0 0 0 0 12 
3 0 0 0 0 42 0 0 0 0 0 0 0 0 0 0 0 0 0 0 0 0 42 0 0 0 0 0 0 0 0 13 
1 0 0 0 0 42 0 0 0 0 0 0 0 0 0 0 0 0 0 0 0 0 42 0 0 0 0 0 0 0 0 11 
2 0 0 0 0 42 0 0 0 0 0 0 0 0 0 0 0 0 0 0 0 0 42 0 0 0 0 0 0 0 0 12 
3 0 0 0 0 42 0 0 0 0 0 0 0 0 0 0 0 0 0 0 0 0 42 0 0 0 0 0 0 0 0 12 
1 0 0 0 0 42 0 0 0 0 0 0 0 0 0 0 0 0 0 0 0 0 42 0 0 0 0 0 54 55 53 11 
2 0 0 0 0 42 0 0 0 0 0 0 0 0 0 0 0 0 0 0 0 0 42 0 0 0 0 0 52 0 51 12 
3 0 0 0 0 42 0 0 0 0 0 0 0 0 0 0 5 25 25 25 25 25 35 25 25 25 25 25 43 25 44 11 
1 0 0 0 0 42 0 0 0 0 0 0 0 0 0 0 23 41 24 34 31 23 24 34 31 23 24 34 31 23 24 11 
2 0 0 0 0 42 0 0 0 0 0 0 0 0 0 0 0 42 0 0 0 0 0 0 0 0 0 0 0 0 0 12 
3 0 0 0 0 42 0 0 0 0 0 0 0 0 0 0 0 42 0 0 0 0 0 0 0 0 0 0 0 0 0 13 
1 0 0 0 0 42 0 0 0 0 0 0 0 0 0 0 0 42 0 0 0 0 0 0 0 0 0 0 0 0 0 12 
1 0 0 0 0 42 0 0 0 0 0 0 0 0 0 0 0 42 0 0 0 0 0 0 0 0 0 0 0 0 0 11 
32 25 25 25 25 35 25 25 25 25 25 25 25 25 25 25 25 35 25 25 25 25 25 15 0 0 0 0 0 0 0 12 
21 22 21 22 21 22 21 22 21 22 21 22 21 22 21 4 24 23 24 34 31 23 41 6 0 0 0 0 0 0 0 13 
22 21 22 21 22 21 22 21 22 21 22 21 22 21 22 1 0 0 0 0 0 0 42 0 0 0 0 0 0 0 0 11 
21 22 21 22 21 22 21 22 21 22 21 22 21 22 21 2 0 0 0 0 0 0 42 0 0 0 0 0 0 0 0 12 
22 21 22 21 22 21 22 21 22 21 22 21 22 21 22 0 0 0 0 0 0 0 42 0 0 0 0 0 0 0 0 13 
20 20 20 20 20 20 20 20 20 20 20 20 20 20 20 20 20 20 20 20 20 20 20 20 20 20 20 20 20 20 20 20 