TILEMAP
32 20							-- Size of tile map in tiles
16 16 							-- Tile size & block size
images/walls_blue.png 	-- Tilesheet
10 10   
19 19 19 19 19 19 19 19 19 19 19 19 19 19 19 19 19 19 19 19 19 19 19 19 19 19 19 19 19 19 19 19 
2 0 42 0 0 0 0 0 40 0 0 0 0 0 0 0 0 0 0 0 0 40 0 0 0 0 0 40 0 0 0 12 
1 0 42 0 0 0 0 0 56 50 50 50 50 50 50 50 50 50 50 50 50 56 0 0 0 0 0 30 0 0 0 11 
32 25 35 25 25 25 15 0 40 0 0 0 0 0 0 0 0 0 0 0 0 40 0 5 25 25 25 60 25 25 25 33 
4 34 31 23 24 41 31 0 40 0 0 0 0 0 0 0 0 0 0 0 0 40 0 23 41 23 24 56 50 50 50 50 
2 0 0 0 0 42 0 0 40 0 0 0 0 0 0 0 0 0 0 0 0 40 0 0 42 0 0 40 0 0 0 20 
1 0 0 0 0 42 0 0 56 50 50 50 50 50 50 50 50 50 50 50 50 56 0 0 42 0 0 30 0 0 0 20 
32 25 25 25 25 35 25 25 60 25 25 25 15 0 0 0 5 25 25 25 25 60 25 25 35 25 25 60 25 25 25 25 
4 23 41 34 31 23 24 34 31 23 41 34 31 0 0 0 34 23 41 34 31 56 50 50 50 50 50 56 23 41 34 31 
1 0 42 0 0 0 0 0 0 0 42 0 0 0 0 0 0 0 42 0 0 40 0 0 0 0 0 40 0 42 0 20 
3 0 42 0 0 0 0 0 0 0 42 0 0 0 0 0 0 0 42 0 0 40 0 0 0 0 0 40 0 42 0 20 
2 0 42 0 0 0 0 0 0 0 42 0 0 0 0 0 0 0 42 0 0 40 0 0 0 0 0 40 0 42 0 20 
1 0 42 0 0 0 0 0 0 0 42 0 0 0 0 0 0 0 42 0 0 30 0 0 0 0 0 30 0 42 0 20 
3 0 42 0 0 0 0 0 5 25 35 25 25 25 25 25 25 25 35 25 25 60 25 25 25 25 25 60 25 35 25 25 
2 0 42 0 0 0 0 0 31 23 24 34 31 41 23 24 34 31 23 24 34 56 50 50 50 50 50 56 34 31 23 24 
1 0 42 0 0 0 0 0 0 0 0 0 0 42 0 0 0 0 0 0 0 40 0 0 0 0 0 40 0 0 0 20 
3 0 42 0 64 65 66 0 0 0 0 0 0 42 0 0 0 0 0 0 0 40 0 0 0 0 0 40 0 0 0 20 
2 0 42 0 74 75 76 0 0 0 0 0 0 42 0 0 54 55 53 0 0 40 0 0 0 0 0 40 0 0 0 20 
1 0 42 0 84 85 86 0 0 0 0 0 0 42 0 0 52 0 51 0 0 30 0 0 0 0 0 30 0 0 0 20 
32 25 35 25 94 95 96 25 25 25 25 25 25 35 25 25 43 25 44 25 25 60 25 25 25 25 25 60 25 25 25 25 