TILEMAP
32 20							-- Size of tile map in tiles
16 16 							-- Tile size & block size
images/walls_red.png 	-- Tilesheet
10 10   
4 0 0 0 0 0 0 0 0 0 0 0 0 0 0 0 0 0 0 0 0 0 0 0 0 0 0 0 0 0 0 20 
1 0 0 0 0 0 0 0 0 0 0 0 0 0 0 0 0 0 0 0 0 0 0 0 0 0 0 0 0 0 0 20 
3 0 0 0 0 0 0 0 0 0 0 0 0 0 0 64 65 66 0 0 0 0 0 0 0 0 0 0 0 0 0 20 
2 0 0 0 0 0 0 0 0 0 0 0 0 0 0 74 75 76 0 0 0 0 0 54 55 53 0 0 0 0 0 20 
19 0 0 0 0 0 0 0 0 0 0 0 0 0 0 84 85 86 0 0 0 0 0 52 0 51 0 0 0 0 0 20 
19 0 0 0 0 0 0 0 5 25 25 25 25 25 25 94 25 96 25 25 25 25 25 43 25 44 25 25 25 25 25 25 
19 0 0 0 0 0 0 0 23 24 41 34 31 23 24 34 31 23 24 34 31 23 24 34 31 23 24 34 31 23 24 34 
19 0 0 0 0 0 0 0 0 0 42 0 0 0 0 0 0 0 0 0 0 0 0 0 0 0 0 0 0 0 0 20 
19 0 0 0 0 0 0 0 0 0 42 0 0 0 0 0 0 0 0 0 0 0 0 0 0 0 0 0 0 0 0 20 
25 25 25 25 25 25 25 25 25 25 35 15 17 18 18 18 18 18 18 18 18 18 18 18 18 18 18 18 5 25 25 25 
4 23 24 34 31 23 24 34 31 23 24 6 7 8 8 8 8 8 8 8 8 8 8 8 8 8 8 8 6 23 24 34 
2 0 0 0 0 0 0 0 0 0 0 0 0 0 0 0 0 0 0 0 0 0 0 0 0 0 0 0 0 0 0 0 
1 0 0 0 0 0 0 0 0 0 0 0 0 0 0 0 0 0 0 0 0 0 0 0 0 0 0 0 0 0 0 0 
3 0 0 0 0 0 0 0 0 0 0 0 0 0 0 0 0 0 0 0 0 0 0 0 0 0 0 0 0 0 0 0 
2 0 0 0 0 0 0 0 0 0 0 0 0 0 0 0 0 0 0 0 0 0 0 0 0 0 0 0 0 0 0 0 
1 0 0 0 0 0 0 0 0 0 0 0 0 0 0 0 0 0 0 0 0 0 0 0 0 0 0 0 0 0 0 0 
10 9 10 9 10 9 10 9 10 9 10 9 10 9 10 9 10 9 10 9 10 9 10 9 10 9 10 9 10 9 10 9 
9 10 9 10 9 10 9 10 9 10 9 10 9 10 9 10 9 10 9 10 9 10 9 10 9 10 9 10 9 10 9 10 
10 9 10 9 10 9 10 9 10 9 10 9 10 9 10 9 10 9 10 9 10 9 10 9 10 9 10 9 10 9 10 9 
9 10 9 10 9 10 9 10 9 10 9 10 9 10 9 10 9 10 9 10 9 10 9 10 9 10 9 10 9 10 9 10 
 