TILEMAP
32 20							-- Size of tile map in tiles
16 16 							-- Tile size & block size
images/walls_yellow.png 	-- Tilesheet
10 10   
21 22 21 22 21 22 21 22 21 22 21 22 21 22 21 4 23 24 34 31 23 24 34 31 23 24 34 31 23 24 34 14 
22 21 22 21 22 21 22 21 22 21 22 21 22 21 22 1 0 0 0 0 0 0 0 0 0 0 0 0 0 0 0 11 
21 22 21 22 21 22 21 22 21 22 21 22 21 22 21 2 0 0 0 0 0 0 0 0 0 0 0 0 0 0 0 12 
22 21 22 21 22 21 22 21 22 21 22 21 22 21 22 2 0 0 0 0 0 0 0 0 64 65 66 0 0 0 0 13 
4 23 24 34 31 23 24 34 31 23 24 34 31 23 24 0 0 0 0 0 0 0 0 0 74 75 76 0 0 0 0 11 
19 0 0 0 0 0 0 0 0 0 0 0 0 0 0 0 0 0 0 0 0 0 0 0 84 85 86 0 0 0 0 12 
19 0 0 0 0 0 0 0 0 0 0 0 0 0 0 0 0 0 0 0 0 5 25 25 94 95 96 25 25 15 0 13 
19 0 0 0 61 62 63 0 0 0 0 0 0 0 0 0 0 0 0 0 0 23 41 34 31 23 24 34 31 24 0 11 
19 0 0 0 71 72 73 0 0 0 0 0 0 0 0 0 0 0 0 0 0 0 42 0 0 0 0 0 0 0 0 12 
19 0 0 0 81 82 83 0 0 0 0 0 0 0 0 0 0 0 0 0 0 0 42 0 0 0 0 0 0 0 0 13 
25 25 25 25 91 92 93 15 17 18 18 18 18 18 18 18 18 17 5 25 25 25 35 25 25 25 25 25 25 25 25 33 
24 41 34 31 24 23 34 6 7 8 8 8 8 8 8 8 8 7 6 23 24 34 31 23 24 34 31 41 24 34 31 34 
19 42 0 0 0 0 0 0 0 0 0 0 0 0 0 0 0 0 0 0 0 0 0 0 0 0 0 42 0 0 0 20 
19 42 0 0 0 0 0 0 0 0 0 0 0 0 0 0 0 0 0 0 0 0 0 0 0 0 0 42 0 0 0 20 
19 42 0 0 0 0 0 0 0 0 0 0 0 0 0 0 0 0 0 0 0 0 0 0 0 0 0 42 0 0 0 20 
25 35 25 25 25 25 25 25 25 25 25 25 25 25 25 25 25 25 25 25 25 25 25 25 25 25 25 35 25 25 25 25 
4 23 24 34 31 23 24 34 31 23 24 34 31 23 24 34 31 23 24 34 31 23 24 34 31 23 24 34 31 23 24 34 
1 0 0 0 0 0 0 0 0 0 0 0 0 0 0 0 0 0 0 0 0 0 0 0 0 0 0 0 0 0 0 0 
10 9 10 9 10 9 10 9 10 9 10 9 10 9 10 9 10 9 10 9 10 9 10 9 10 9 10 9 10 9 10 9 
9 10 9 10 9 10 9 10 9 10 9 10 9 10 9 10 9 10 9 10 9 10 9 10 9 10 9 10 9 10 9 10 