TILEMAP
32 20							-- Size of tile map in tiles
16 16 							-- Tile size & block size
images/walls_blue.png 	-- Tilesheet
10 10   
21 22 21 22 21 22 21 22 21 22 21 22 21 22 21 22 21 22 21 22 21 22 21 22 21 22 21 22 21 22 21 22 
22 21 22 21 22 21 22 21 22 21 22 21 22 21 22 21 22 21 22 21 22 21 22 21 22 21 22 21 22 21 22 21 
21 22 21 22 21 22 21 22 21 22 21 22 21 22 21 22 21 22 21 22 21 22 21 22 21 22 21 22 21 22 21 22 
34 31 23 24 34 31 23 24 34 31 23 24 34 31 23 24 34 31 23 24 34 31 23 24 34 31 23 24 34 31 23 14 
50 50 50 50 56 50 50 50 50 50 50 50 50 50 50 50 50 50 50 50 50 50 50 50 50 56 0 0 0 0 0 11 
19 0 0 0 40 0 0 0 0 0 0 0 0 0 0 0 0 0 0 0 0 0 0 0 0 40 0 0 0 0 0 12 
19 0 0 0 40 0 0 0 0 0 0 0 0 0 0 0 0 0 0 0 0 0 0 0 0 40 0 0 0 0 0 13 
25 25 25 25 60 25 25 25 25 15 17 18 18 18 18 18 18 18 18 18 17 5 25 15 0 40 0 0 0 0 0 11 
34 31 23 24 56 31 23 24 23 6 7 8 8 8 8 8 8 8 8 8 7 6 41 23 0 40 0 0 0 0 0 12 
19 0 0 0 40 0 0 0 0 0 0 0 0 0 0 0 0 0 0 0 0 0 42 0 0 40 0 61 62 63 0 11 
19 0 0 0 56 50 50 50 50 50 50 50 50 50 50 56 0 0 0 0 0 0 42 0 0 40 0 71 72 73 0 12 
19 0 0 0 40 0 0 0 0 0 54 55 53 0 0 40 0 0 0 0 0 0 42 0 0 40 0 81 82 83 0 13 
19 0 0 0 40 0 0 0 0 0 52 0 51 0 0 40 0 0 0 0 0 0 42 0 5 60 25 91 92 93 25 33 
25 25 25 25 60 25 25 25 25 25 43 25 44 15 0 40 0 0 0 0 0 0 42 11 70 70 70 70 70 70 70 70 
31 23 24 34 56 23 24 34 31 23 24 34 31 23 0 40 0 0 0 0 0 0 42 12 70 70 70 70 70 70 70 70 
19 0 0 0 40 0 0 0 0 0 0 0 0 0 0 40 0 0 0 0 0 0 42 11 70 70 70 70 70 70 70 70 
19 0 0 0 40 0 0 0 0 0 0 0 0 0 0 40 0 27 28 29 0 0 42 12 70 70 70 70 70 70 70 70 
19 0 0 0 40 0 0 0 0 0 0 0 0 0 0 40 0 37 38 39 0 0 42 13 70 70 70 70 70 70 70 70 
19 0 0 0 30 50 50 50 50 50 50 50 50 50 50 30 0 47 48 49 0 0 42 13 70 70 70 70 70 70 70 70 
25 25 25 25 60 25 25 25 25 25 25 25 25 25 25 60 25 57 58 59 25 25 35 33 70 70 70 70 70 70 70 70 