TILEMAP
32 20							-- Size of tile map in tiles
16 16 							-- Tile size & block size
images/walls_red.png 	-- Tilesheet
10 10   
21 22 21 22 21 22 21 22 21 22 21 22 21 22 21 22 21 22 21 22 21 22 21 22 21 22 21 22 21 22 21 22 
22 21 22 21 22 21 22 21 22 21 22 21 22 21 22 21 22 21 22 21 22 21 22 21 22 21 22 21 22 21 22 21 
21 22 21 22 21 22 21 22 21 22 21 22 21 22 21 22 21 22 21 22 21 22 21 22 21 22 21 22 21 22 21 22 
22 21 22 21 22 21 22 21 22 21 22 21 22 21 22 21 22 21 22 21 22 21 22 21 22 21 22 21 22 21 22 21 
4 23 24 34 31 23 24 34 31 23 24 34 31 23 24 34 31 23 24 34 31 23 24 34 31 23 24 34 31 23 14 34 
3 0 0 0 0 0 0 0 0 0 0 0 0 0 0 0 0 0 0 0 0 0 0 0 0 0 0 0 0 0 0 20 
2 0 0 0 0 0 0 0 0 0 0 0 67 68 69 0 0 0 0 0 0 0 0 0 0 0 0 0 0 0 0 20 
1 0 0 0 0 0 0 0 54 55 53 0 77 78 79 0 0 0 0 0 0 0 0 0 0 0 0 0 0 0 0 20 
1 0 0 0 0 0 0 0 52 0 51 0 87 88 89 0 0 0 0 0 0 0 0 0 0 0 0 0 0 0 0 20 
3 0 0 5 25 25 25 25 43 25 44 25 97 25 99 25 25 25 25 25 15 0 0 0 0 0 5 25 25 25 25 25 
2 0 0 23 6 41 24 34 31 24 23 34 31 24 23 34 31 24 41 6 23 0 0 0 0 0 23 24 34 31 23 14 
1 0 0 0 0 42 0 0 0 0 0 0 0 0 0 0 0 0 42 0 0 0 0 0 0 0 0 0 0 0 0 11 
3 0 0 0 0 42 0 0 0 0 0 0 0 0 0 0 0 0 42 0 0 0 61 62 63 0 0 0 0 0 0 13 
2 0 0 0 0 42 0 0 0 0 54 55 53 0 0 0 0 0 42 0 0 0 71 72 73 0 0 0 0 0 0 12 
1 0 0 0 0 42 0 0 0 0 52 0 51 0 0 0 0 0 42 0 0 0 81 82 83 0 0 0 0 0 0 11 
32 25 25 25 25 35 25 25 25 25 43 25 44 25 25 25 25 25 35 25 25 25 91 92 93 25 25 25 25 25 25 33 
21 22 21 22 21 22 21 22 21 22 21 22 21 22 21 22 21 22 21 22 21 22 21 22 21 22 21 22 21 22 21 22 
22 21 22 21 22 21 22 21 22 21 22 21 22 21 22 21 22 21 22 21 22 21 22 21 22 21 22 21 22 21 22 21 
21 22 21 22 21 22 21 22 21 22 21 22 21 22 21 22 21 22 21 22 21 22 21 22 21 22 21 22 21 22 21 22 
22 21 22 21 22 21 22 21 22 21 22 21 22 21 22 21 22 21 22 21 22 21 22 21 22 21 22 21 22 21 22 21 