TILEMAP
32 20							-- Size of tile map in tiles
16 16 							-- Tile size & block size
images/walls_blue.png 	-- Tilesheet
10 10   
21 22 21 22 21 22 21 22 21 22 21 22 21 22 21 22 21 22 21 22 1 30 11 22 21 22 1 30 11 22 21 22 
21 22 21 22 21 22 21 22 21 22 21 22 21 22 21 22 21 22 21 22 2 40 12 22 21 22 2 40 12 22 21 22 
21 22 21 22 21 22 21 22 21 22 21 22 21 22 21 22 21 22 21 22 3 40 13 22 21 22 3 40 13 22 21 22 
21 22 21 22 21 22 21 22 21 22 21 22 21 22 21 22 21 22 21 22 1 30 11 22 21 22 1 30 11 22 21 22 
4 23 24 34 31 23 24 34 31 23 24 34 31 23 24 34 31 23 24 34 0 40 0 23 24 23 0 40 0 23 24 14 
1 0 0 61 62 63 0 0 0 0 0 0 0 0 0 0 0 0 0 0 0 40 0 0 0 0 0 40 0 0 0 11 
3 0 0 71 72 73 0 0 0 0 0 0 0 0 0 0 0 0 0 0 0 30 0 0 0 0 0 30 0 0 0 12 
2 0 0 81 82 83 0 0 0 0 0 0 0 0 0 0 0 0 0 0 0 40 0 64 65 66 0 40 0 0 0 13 
1 0 5 91 92 93 25 25 25 25 15 0 0 0 0 0 0 0 0 0 0 40 0 74 75 76 0 40 0 0 0 11 
3 0 23 23 34 31 23 24 41 23 24 0 0 0 0 0 0 0 0 0 0 30 0 84 85 86 0 30 0 0 0 12 
2 0 0 0 0 0 0 0 42 0 0 0 0 0 0 5 25 25 25 25 25 60 25 94 95 96 25 60 15 0 0 13 
1 0 0 0 0 0 0 0 42 0 0 0 0 0 0 23 24 23 41 34 31 56 50 50 50 50 50 56 23 0 0 11 
3 0 0 0 0 0 0 0 42 0 0 0 0 0 0 0 0 0 42 0 0 40 0 0 0 0 0 40 0 0 0 12 
2 0 0 0 0 0 0 0 42 0 0 0 54 55 53 0 0 0 42 0 0 40 0 0 0 0 0 40 0 0 0 13 
1 0 0 0 0 0 0 0 42 0 0 0 52 0 51 0 0 0 42 0 0 30 0 0 0 0 0 30 0 0 0 11 
32 25 25 25 25 25 25 25 35 25 25 25 43 25 44 25 25 25 35 25 25 60 25 25 25 25 25 60 25 25 25 33 
4 23 41 23 24 34 31 23 56 50 50 50 50 50 50 50 50 50 50 50 50 56 50 50 50 50 50 56 0 0 0 14 
3 0 42 0 0 0 0 0 40 0 0 0 0 0 0 0 0 0 0 0 0 40 0 0 0 0 0 40 0 0 0 11 
2 0 42 0 0 0 0 0 30 0 0 0 0 0 0 0 0 0 0 0 0 30 0 0 0 0 0 30 0 0 0 12 
19 19 19 19 19 19 19 19 19 19 19 19 19 19 19 19 19 19 19 19 19 19 19 19 19 19 19 19 19 19 19 19 