TILEMAP
32 20							-- Size of tile map in tiles
16 16 							-- Tile size & block size
images/walls_red.png 	-- Tilesheet
6 8   
13 14 13 14 13 14 13 14 13 14 13 14 13 14 13 14 13 14 13 14 13 14 13 14 13 14 13 14 13 14 13 14 
14 13 14 13 14 13 14 13 14 13 14 13 14 13 14 13 14 13 14 13 14 13 14 13 14 13 14 13 14 13 14 13 
13 14 13 14 13 14 13 14 13 14 13 14 13 14 13 14 13 14 13 14 13 14 13 14 13 14 13 14 13 14 13 14 
14 13 14 13 14 13 14 13 14 13 14 13 14 13 14 13 14 13 14 13 14 13 14 13 14 13 14 13 14 13 14 13 
4 15 16 22 19 15 16 22 19 15 16 22 19 16 15 22 19 16 15 10 4 15 16 22 19 15 16 22 19 15 16 22 
2 0 0 0 0 0 0 0 0 0 0 0 0 0 0 0 0 0 0 0 0 0 0 0 0 0 0 0 0 0 0 36 
3 0 0 0 0 0 0 0 0 0 0 0 0 0 0 0 0 0 0 0 0 0 0 0 0 0 0 0 0 0 0 36 
1 0 0 0 0 0 0 0 34 35 33 0 0 0 0 0 0 0 0 0 0 0 0 0 0 0 0 0 0 0 0 36 
3 0 0 0 0 0 0 0 32 0 31 0 0 0 0 0 0 0 0 0 0 0 0 0 0 0 0 0 0 0 0 36 
1 0 0 5 17 17 17 17 27 17 28 17 17 29 17 17 17 17 17 11 0 0 0 0 0 0 0 5 17 17 17 17 
2 0 0 15 6 25 22 19 16 15 22 19 16 15 22 19 16 25 6 15 0 0 0 0 0 0 0 15 6 25 16 10 
1 0 0 0 0 26 12 18 0 0 0 0 0 0 0 0 0 26 0 0 0 0 0 0 0 0 0 0 0 26 0 9 
3 0 0 0 0 26 0 0 0 0 0 0 0 0 0 0 0 26 0 0 0 0 0 0 0 0 0 0 0 26 0 8 
2 0 0 0 0 26 0 0 0 34 35 33 0 0 0 0 0 26 0 0 0 0 0 0 0 0 0 0 0 26 0 9 
1 0 0 0 0 26 0 0 0 32 0 31 0 0 0 0 0 26 0 0 0 0 0 0 0 0 0 0 0 26 0 7 
20 17 17 17 17 23 17 17 17 27 17 28 17 17 17 17 17 23 17 17 17 17 24 17 30 17 17 17 17 23 17 21 
13 14 13 14 13 14 13 14 13 14 13 14 13 14 13 14 13 14 13 14 13 14 13 14 13 14 13 14 13 14 13 14 
14 13 14 13 14 13 14 13 14 13 14 13 14 13 14 13 14 13 14 13 14 13 14 13 14 13 14 13 14 13 14 13 
13 14 13 14 13 14 13 14 13 14 13 14 13 14 13 14 13 14 13 14 13 14 13 14 13 14 13 14 13 14 13 14 
14 13 14 13 14 13 14 13 14 13 14 13 14 13 14 13 14 13 14 13 14 13 14 13 14 13 14 13 14 13 14 13 