TILEMAP
32 20							-- Size of tile map in tiles
16 16 							-- Tile size & block size
images/walls_yellow.png 	-- Tilesheet
10 10   
4 24 23 34 31 24 23 34 31 24 23 34 31 24 23 24 14 21 22 21 22 21 22 21 22 21 22 21 22 21 22 21 
1 0 0 0 0 0 0 0 0 0 0 0 0 0 0 0 11 22 21 22 21 22 21 22 21 22 21 22 21 22 21 22 
2 0 0 0 0 0 0 0 0 0 0 0 0 0 0 0 11 21 22 21 22 21 22 21 22 21 22 21 22 21 22 21 
3 0 5 25 25 25 25 15 0 0 0 0 0 0 0 0 12 22 21 22 21 22 21 22 21 22 21 22 21 22 21 22 
1 0 23 24 41 34 31 24 0 0 0 0 0 0 0 0 11 21 22 21 22 21 22 21 22 21 22 21 22 21 22 21 
2 0 0 0 42 0 0 0 0 0 0 0 0 0 0 0 12 22 21 22 21 22 21 22 21 22 21 22 21 22 21 22 
3 0 0 0 42 0 0 0 0 0 0 0 0 0 0 0 13 21 22 21 22 21 22 21 22 21 22 21 22 21 22 21 
1 0 0 0 42 0 0 0 0 0 0 0 0 0 0 0 11 22 21 22 21 22 21 22 21 22 21 22 21 22 21 22 
2 0 0 0 42 0 0 0 0 0 0 0 0 0 0 0 12 21 22 21 22 21 22 21 22 21 22 21 22 21 22 21 
3 0 5 25 35 25 25 25 25 25 25 25 15 0 0 0 13 22 21 22 21 22 21 22 21 22 21 22 21 22 21 22 
1 0 23 24 34 31 23 24 34 31 41 23 24 0 0 0 11 21 22 21 22 21 22 21 22 21 22 21 22 21 22 21 
1 0 0 0 0 0 0 0 0 0 42 0 0 0 0 0 11 22 21 22 21 22 21 22 21 22 21 22 21 22 21 22 
19 0 0 0 0 0 0 0 0 0 42 0 0 0 0 0 0 23 24 34 31 23 24 34 31 23 24 34 31 23 24 14 
19 0 0 0 0 0 0 0 0 0 42 0 0 0 0 0 0 0 0 0 0 0 0 0 0 0 0 0 0 0 0 0 
19 0 0 0 0 0 0 0 0 0 42 0 0 0 0 0 0 0 0 0 0 0 0 0 0 0 0 0 0 0 0 0 
25 25 25 25 25 25 25 25 25 25 35 25 25 25 15 0 0 0 0 0 0 0 0 0 0 0 0 0 0 0 0 0 
23 24 34 31 23 24 34 31 23 24 34 31 23 24 6 0 0 0 0 0 0 0 0 0 0 0 0 0 0 0 0 0 
0 0 0 0 0 0 0 0 0 0 0 0 0 0 0 0 0 0 0 0 0 0 0 0 0 0 0 0 0 0 0 0 
10 9 10 9 10 9 10 9 10 9 10 9 10 9 10 9 10 9 10 9 10 9 10 9 10 9 10 9 10 9 10 9 
9 10 9 10 9 10 9 10 9 10 9 10 9 10 9 10 9 10 9 10 9 10 9 10 9 10 9 10 9 10 9 10 