TILEMAP
32 20							-- Size of tile map in tiles
16 16 							-- Tile size & block size
images/walls_red.png 	-- Tilesheet
6 8   
4 15 16 22 19 15 16 22 19 15 16 22 19 15 16 22 19 15 16 22 19 15 16 22 19 15 16 22 19 15 16 22 
1 0 0 0 0 0 0 0 0 0 0 0 0 0 0 0 0 0 0 0 0 0 0 0 0 0 0 0 0 0 0 36 
3 0 0 0 0 0 0 0 0 0 0 0 0 0 0 0 0 0 0 0 0 0 0 0 0 0 0 0 0 0 0 36 
1 0 0 0 0 0 0 0 0 0 0 0 0 0 0 0 0 0 0 0 0 0 0 0 34 35 33 0 0 0 0 36 
42 0 0 0 0 0 0 0 0 0 0 0 0 0 0 0 0 0 0 0 0 0 0 0 32 0 31 0 0 0 0 36 
42 0 0 0 0 0 0 0 5 17 17 17 17 17 17 17 17 17 17 17 17 17 17 17 27 17 28 17 17 17 17 17 
42 0 0 0 0 0 0 0 19 15 25 22 19 16 15 22 19 16 15 22 19 16 15 22 19 16 15 22 19 16 15 22 
42 0 0 0 0 0 0 0 0 0 26 0 0 0 0 0 0 0 0 0 0 0 0 0 0 0 0 0 0 0 0 36 
42 0 0 0 0 0 0 0 0 0 26 0 0 0 0 0 0 0 0 0 0 0 0 0 0 0 0 0 0 0 0 36 
17 17 17 17 17 17 17 17 17 17 23 11 37 38 38 38 38 38 38 38 38 38 38 38 38 38 38 38 5 17 17 17 
4 15 16 22 19 15 16 22 19 15 16 6 43 41 41 41 41 41 41 41 41 41 41 41 41 41 41 43 6 16 15 22 
1 0 0 0 0 0 0 0 0 0 0 0 0 0 0 0 0 0 0 0 0 0 0 0 0 0 0 0 0 0 0 0 
2 0 0 0 0 0 0 0 0 0 0 0 0 0 0 0 0 0 0 0 0 0 0 0 0 0 0 0 0 0 0 0 
3 0 0 0 0 0 0 0 0 0 0 0 0 0 0 0 0 0 0 0 0 0 0 0 0 0 0 0 0 0 0 0 
1 0 0 0 0 0 0 0 0 0 0 0 0 0 0 0 0 0 0 0 0 0 0 0 0 0 0 0 0 0 0 0 
1 0 0 0 0 0 0 0 0 0 0 0 0 0 0 0 0 0 0 0 0 0 0 0 0 0 0 0 0 0 0 0 
39 40 39 40 39 40 39 40 39 40 39 40 39 40 39 40 39 40 39 40 39 40 39 40 39 40 39 40 39 40 39 40 
40 39 40 39 40 39 40 39 40 39 40 39 40 39 40 39 40 39 40 39 40 39 40 39 40 39 40 39 40 39 40 39 
39 40 39 40 39 40 39 40 39 40 39 40 39 40 39 40 39 40 39 40 39 40 39 40 39 40 39 40 39 40 39 40 
40 39 40 39 40 39 40 39 40 39 40 39 40 39 40 39 40 39 40 39 40 39 40 39 40 39 40 39 40 39 40 39 
 