TILEMAP
32 20							-- Size of tile map in tiles
16 16 							-- Tile size & block size
images/walls_red.png 	-- Tilesheet
10 10   
31 24 23 34 31 24 23 34 31 24 23 34 31 24 23 34 31 24 23 34 31 24 23 34 31 24 23 34 31 24 23 14 
19 0 0 0 0 0 0 0 0 0 0 0 0 0 0 0 0 0 0 54 55 53 0 0 0 0 0 0 0 0 0 11 
19 0 0 0 0 0 0 0 0 0 0 0 0 0 0 0 0 0 0 52 0 51 0 0 0 0 0 0 0 0 0 12 
19 0 0 0 0 54 55 53 0 0 0 0 0 0 0 0 5 25 25 43 25 44 25 25 25 25 25 25 25 25 15 13 
19 0 0 0 0 52 0 51 0 0 0 0 0 0 0 0 24 23 34 31 24 23 34 31 24 23 41 31 24 23 34 11 
25 25 25 25 25 43 25 44 25 25 25 25 15 0 0 0 0 0 0 0 0 0 0 0 0 0 42 0 0 0 0 12 
31 24 23 34 31 24 23 34 31 24 41 6 23 0 0 0 0 0 0 0 0 0 0 61 62 63 42 0 0 0 0 13 
19 0 0 0 0 0 0 0 0 0 42 0 0 0 0 0 0 0 0 0 0 0 0 71 72 73 42 0 0 0 0 11 
19 0 0 0 0 0 0 0 0 0 42 0 0 0 0 0 0 0 0 0 0 0 0 81 82 83 42 0 0 0 0 12 
25 25 25 25 25 25 25 25 25 25 35 25 25 25 25 15 0 0 0 5 25 25 25 91 92 93 35 15 0 0 0 13 
4 23 24 34 31 23 24 34 31 23 24 34 31 41 23 34 0 0 0 24 41 34 31 24 23 34 31 24 0 0 0 11 
1 0 0 0 0 0 0 0 0 0 0 0 0 42 0 0 0 0 0 0 42 0 0 0 0 0 0 0 0 0 0 12 
2 0 0 61 62 63 0 0 0 0 0 0 0 42 0 0 0 0 0 0 42 0 0 0 0 0 0 64 65 66 0 13 
3 0 0 71 72 73 0 0 0 54 55 53 0 42 0 0 0 0 0 0 42 0 0 0 0 0 0 74 75 76 0 11 
1 0 0 81 82 83 0 0 0 52 0 51 0 42 0 0 0 0 0 0 42 0 0 0 0 0 0 84 85 86 0 12 
32 25 25 91 92 93 25 25 25 43 25 44 25 35 25 25 25 25 25 25 35 25 25 25 25 25 25 94 25 96 25 33 
21 22 21 22 21 22 21 22 21 22 21 22 21 22 21 22 21 22 21 22 21 22 21 22 21 22 21 22 21 22 21 22 
22 21 22 21 22 21 22 21 22 21 22 21 22 21 22 21 22 21 22 21 22 21 22 21 22 21 22 21 22 21 22 21 
21 22 21 22 21 22 21 22 21 22 21 22 21 22 21 22 21 22 21 22 21 22 21 22 21 22 21 22 21 22 21 22 
22 21 22 21 22 21 22 21 22 21 22 21 22 21 22 21 22 21 22 21 22 21 22 21 22 21 22 21 22 21 22 21 
 