TILEMAP
32 20							-- Size of tile map in tiles
16 16 							-- Tile size & block size
images/walls_blue.png 	-- Tilesheet
10 10   
4 24 23 34 31 24 23 34 31 24 23 34 31 24 23 34 31 24 23 34 31 24 23 34 31 24 23 34 31 24 23 14 
1 0 0 0 0 0 0 0 0 0 0 0 0 0 0 0 0 0 0 0 0 0 0 0 0 0 0 0 0 0 0 11 
2 0 0 0 0 0 0 0 0 0 0 0 0 0 0 0 0 0 0 0 0 0 0 0 0 0 0 0 0 0 0 12 
3 0 0 0 0 0 0 0 0 5 25 25 25 25 25 25 25 25 25 25 25 25 25 25 25 25 15 0 0 0 0 13 
1 0 0 0 0 0 0 0 0 24 23 41 23 24 34 31 23 24 34 31 23 24 34 31 23 24 34 0 0 0 0 11 
2 0 0 0 0 0 0 0 0 0 0 42 0 0 0 0 0 0 0 0 0 0 0 0 0 0 0 0 0 0 0 12 
3 0 61 62 63 0 0 0 0 0 0 42 0 0 0 0 0 0 0 0 0 0 0 0 0 0 0 64 65 66 0 13 
1 0 71 72 73 0 0 0 0 0 0 42 0 0 0 0 0 0 0 0 0 0 0 0 0 0 0 74 75 76 0 11 
2 0 81 82 83 0 0 0 0 0 0 42 0 0 0 0 0 0 0 0 0 0 0 0 0 0 0 84 85 86 0 12 
32 25 91 92 93 25 25 25 25 25 25 35 15 17 18 18 18 18 18 18 17 5 25 25 25 25 25 94 95 96 25 33 
4 23 34 31 24 41 34 31 24 23 34 31 6 7 8 8 8 8 8 8 7 6 41 23 24 23 34 31 24 23 34 14 
1 0 0 0 0 42 0 0 0 0 0 0 0 0 0 0 0 0 0 0 0 0 42 0 0 0 0 0 0 0 0 11 
2 0 0 0 0 42 0 0 0 0 0 0 0 0 0 0 0 0 0 0 0 0 42 0 0 0 0 0 0 0 0 12 
3 0 0 0 0 42 0 0 0 0 0 0 0 0 0 0 0 0 0 0 0 0 42 0 0 0 0 0 0 0 0 13 
1 0 0 0 0 42 0 0 0 0 0 0 0 0 0 0 0 0 0 0 0 0 42 0 0 0 0 0 0 0 0 11 
2 0 0 0 0 42 0 0 0 0 0 0 0 0 0 0 0 0 0 0 0 0 42 0 0 0 0 0 0 0 0 12 
3 0 0 0 0 42 0 0 0 0 0 0 0 0 0 0 0 0 0 0 0 0 42 0 0 0 0 0 0 0 0 13 
1 0 0 0 0 42 0 0 0 0 0 0 0 0 0 0 0 0 0 0 0 0 42 0 0 0 0 0 0 0 0 11 
2 0 0 0 0 42 0 0 0 0 0 0 0 0 0 0 0 0 0 0 0 0 42 0 0 0 0 0 0 0 0 12 
20 20 20 20 20 20 20 20 20 20 20 20 20 20 20 20 20 20 20 20 20 20 20 20 20 20 20 20 20 20 20 20 
 