TILEMAP
32 20							-- Size of tile map in tiles
16 16 							-- Tile size & block size
images/walls_blue.png 	-- Tilesheet
10 10   
19 19 19 19 19 19 19 19 19 19 19 19 19 19 19 19 19 19 19 19 19 19 19 19 19 19 19 19 19 19 19 19 
22 21 22 21 22 21 22 21 22 21 22 21 22 21 22 2 0 0 0 0 0 0 42 0 0 0 0 0 0 0 0 12 
21 22 21 22 21 22 21 22 21 22 21 22 21 22 21 3 0 0 0 0 0 0 42 0 54 55 53 0 0 0 0 13 
4 23 24 34 31 23 24 34 31 23 24 34 31 23 24 0 0 0 0 0 0 0 42 0 52 0 51 0 0 0 0 11 
2 0 0 0 0 0 0 0 0 0 0 0 0 0 0 0 0 0 0 0 5 25 35 25 43 25 44 25 15 0 0 12 
3 0 0 0 0 0 0 0 0 0 0 0 0 0 0 0 0 0 0 0 23 24 34 31 23 24 34 31 41 0 0 13 
1 0 0 0 0 0 0 0 0 0 0 0 0 0 0 0 0 0 0 0 0 0 0 0 0 0 0 0 42 0 0 11 
2 5 25 25 25 25 25 25 15 0 0 0 0 0 0 0 0 0 0 0 0 0 0 0 0 0 0 0 42 0 0 12 
3 23 41 23 24 34 31 23 24 0 0 0 0 0 64 65 66 0 0 0 0 0 0 0 0 0 0 0 42 0 0 13 
1 0 42 0 0 0 0 0 0 0 0 0 0 0 74 75 76 0 0 0 0 0 0 5 25 25 25 25 35 15 0 11 
2 0 42 0 0 0 0 0 0 0 0 0 0 0 84 85 86 0 0 0 0 0 0 24 41 23 24 34 31 23 0 12 
2 0 42 0 0 0 0 0 0 0 5 25 25 25 94 95 96 25 25 25 15 0 0 0 42 0 0 0 0 0 0 13 
2 0 42 0 0 0 0 0 0 0 23 24 34 31 23 24 34 31 23 24 23 0 0 0 42 0 0 0 0 0 0 11 
3 0 42 0 0 0 0 0 0 0 0 0 0 0 0 0 0 0 0 0 0 0 0 0 42 0 0 0 0 0 0 12 
1 0 42 0 0 0 0 0 0 0 0 0 0 0 0 0 0 0 0 0 0 0 0 0 42 0 0 0 0 0 0 13 
32 25 35 25 25 25 25 25 25 25 15 17 18 18 18 18 18 18 18 18 18 17 25 25 35 25 25 25 25 25 25 33 
4 23 24 34 31 23 24 34 31 23 6 7 8 8 8 8 8 8 8 8 8 7 6 34 31 23 24 34 31 23 24 14 
2 0 0 0 0 0 0 0 0 0 0 0 0 0 0 0 0 0 0 0 0 0 0 0 0 0 0 0 0 0 0 12 
70 70 70 70 70 70 70 70 70 70 70 70 70 70 70 70 70 70 70 70 70 70 70 70 70 70 70 70 70 70 70 70 
70 70 70 70 70 70 70 70 70 70 70 70 70 70 70 70 70 70 70 70 70 70 70 70 70 70 70 70 70 70 70 70 