TILEMAP
32 20							-- Size of tile map in tiles
16 16 							-- Tile size & block size
images/walls_green.png 	-- Tilesheet
10 10   
20 20 20 20 20 20 20 20 20 20 20 20 20 20 20 20 20 20 20 20 20 20 20 20 20 20 20 20 20 20 20 20 
22 21 22 21 22 21 2 0 0 0 0 0 0 0 0 0 0 0 0 0 0 0 0 0 0 0 42 0 0 0 0 13 
21 22 21 22 21 22 3 0 0 0 0 0 0 0 0 0 0 0 0 0 0 0 0 0 0 0 42 0 0 0 0 11 
22 21 22 21 22 21 1 0 0 0 0 54 55 53 0 0 0 0 0 0 0 0 0 0 0 0 42 0 0 0 0 12 
21 22 21 22 21 22 2 0 0 0 0 52 0 51 0 0 0 0 0 0 0 0 0 0 0 0 42 0 0 0 0 12 
22 21 22 21 22 21 3 0 0 5 25 43 25 44 25 25 25 25 25 25 25 25 25 25 25 25 35 25 25 25 25 33 
21 22 21 22 21 22 1 0 0 6 23 41 34 31 23 24 34 31 23 24 34 31 6 41 23 24 34 31 23 24 23 14 
22 21 22 21 22 21 2 0 0 0 0 42 0 0 0 0 0 0 0 0 0 0 0 42 0 0 0 0 0 0 0 11 
21 22 21 22 21 22 3 0 0 0 0 42 0 0 0 0 0 0 0 0 0 0 0 42 0 0 0 0 0 0 0 12 
31 23 24 34 31 23 0 0 0 0 0 42 0 0 0 0 0 0 0 0 0 0 0 42 0 0 0 0 0 0 0 11 
19 0 0 0 0 0 0 0 0 0 0 42 0 0 0 0 0 0 0 0 0 0 0 42 0 0 61 62 63 0 0 13 
19 0 0 54 55 53 0 0 0 0 0 42 0 0 0 0 0 0 0 0 0 0 0 42 0 0 71 72 73 0 0 11 
19 0 0 52 0 51 0 0 0 0 0 42 0 0 0 0 0 0 0 0 0 0 0 42 0 0 81 82 83 0 0 12 
25 25 25 43 25 44 25 25 25 25 25 35 25 25 25 15 0 0 0 0 0 0 5 35 25 25 91 92 93 25 25 33 
21 22 21 22 21 22 21 22 31 23 24 34 31 41 24 34 0 0 0 0 0 0 23 24 34 31 23 24 34 31 23 14 
31 23 24 34 31 23 24 34 0 0 0 0 0 42 0 0 0 0 0 0 0 0 0 0 0 0 0 0 0 0 0 11 
19 0 0 0 0 0 0 0 0 61 62 63 0 42 0 0 0 0 0 0 0 0 0 0 0 0 0 0 0 0 0 13 
19 0 0 0 0 0 0 0 0 71 72 73 0 42 0 0 0 0 0 0 0 0 54 55 53 0 0 0 0 0 0 11 
19 0 0 0 0 0 0 0 0 81 82 83 0 42 0 0 0 0 0 0 0 0 52 0 51 0 0 0 0 0 0 12 
25 25 25 25 25 25 25 25 25 91 92 93 25 35 25 25 25 25 25 25 25 25 43 25 44 25 25 25 25 25 25 33 