TILEMAP
32 20							-- Size of tile map in tiles
16 16 							-- Tile size & block size
images/walls_green.png 	-- Tilesheet
10 10   
4 23 24 34 31 23 24 34 31 23 24 34 31 23 24 34 31 23 24 34 31 23 24 34 31 23 24 34 31 23 24 14 
1 0 0 0 0 0 0 0 0 0 0 0 0 0 0 0 0 0 0 0 0 0 0 0 0 0 0 0 0 0 0 11 
3 0 0 0 0 0 0 0 0 0 0 0 0 0 0 0 0 0 0 0 0 0 0 0 0 0 0 0 0 0 0 12 
3 0 0 0 0 0 0 0 0 0 0 0 0 0 0 0 0 0 0 0 0 0 0 0 0 64 65 66 0 0 0 13 
2 0 0 0 0 0 0 0 0 0 0 0 0 0 0 0 0 0 0 0 0 0 0 0 0 74 75 76 0 0 0 11 
1 0 0 0 0 0 0 0 0 0 0 0 0 0 0 0 0 0 0 0 0 0 0 0 0 84 85 86 0 0 0 12 
3 0 0 0 0 0 0 0 0 0 0 0 0 0 0 0 5 25 25 25 25 25 25 25 25 94 95 96 15 0 0 13 
2 0 0 0 0 0 0 0 0 0 0 0 0 0 0 0 24 34 31 41 23 24 34 31 41 23 24 34 31 0 0 11 
1 0 0 0 0 0 0 0 0 0 0 54 55 53 0 0 0 0 0 42 0 0 0 0 42 0 0 0 0 0 0 12 
3 0 0 0 0 0 0 0 0 0 0 52 0 51 0 0 0 0 0 42 0 0 0 0 42 0 0 0 0 0 0 13 
2 0 0 0 0 5 25 25 25 25 25 43 25 44 25 25 25 25 25 35 25 25 25 25 35 25 15 0 0 0 0 13 
1 0 0 0 0 23 41 23 24 34 31 23 24 34 31 23 24 34 31 23 24 34 31 23 24 34 31 0 0 0 0 11 
3 0 0 0 0 0 42 0 0 0 0 0 0 0 0 0 0 0 0 0 0 0 0 0 0 0 0 0 61 62 63 11 
2 0 54 55 53 0 42 0 0 0 0 0 0 0 0 0 0 0 0 0 0 0 0 0 0 0 0 0 71 72 73 12 
1 0 52 0 51 0 42 0 0 0 0 0 0 0 0 0 0 0 0 0 0 0 0 0 0 0 0 0 81 82 83 13 
32 25 43 25 44 25 35 25 15 17 18 18 18 18 18 18 18 18 17 5 25 25 25 25 25 25 25 25 91 92 93 33 
22 21 22 21 22 21 4 23 24 7 8 8 8 8 8 8 8 8 7 6 23 24 34 31 23 24 41 34 31 23 24 14 
22 21 22 21 22 21 1 0 0 0 0 0 0 0 0 0 0 0 0 0 0 0 0 0 0 0 42 0 0 0 0 13 
22 21 22 21 22 21 2 0 0 0 19 19 19 19 19 0 0 0 0 0 0 0 0 0 0 0 42 0 0 0 0 11 
19 19 19 19 19 19 19 19 19 19 19 19 19 19 19 19 19 19 19 19 19 19 19 19 19 19 19 19 19 19 19 19 